


WE          ./textures/red.png
SO          ./textures/green.png
NO          ./textures/purple.png
EA          ./textures/orange.png



C 135,206,250
F 42,42,46





11111111    11111111111111
10000000111110000000111111
10000000000000000000000001
10000000000000000000000001
10000000000000000000000001
10000000000000001111000001
10000000000000001   110001
10000000000000001     1001
100000000000000111    1101
10000000000000000011111001
10000000000000000000000001
10000000000000000000000001
10000000000000000000000001
10000000000000000N00000001
10001000010000011111111111
1111 1111 1111111111111111