WE          ./textures/orange.png
SO          ./textures/green.png
NO          ./textures/red.png
EA          ./textures/purple.png



C 135,206,0
F 42,42,46




                                        111111111111111111111111111
                                        100000000000000000000000001
                                        110111111111111111111111011
                                        100000000000000000000111011
                                        111000000001001010101111011
                                        111111100000011111101111011
                                        111100000000000000000111011
                                        100000000001000000000000001
                                        100000000010000000000100001
                                        10E000000000000000001111111
                                        1000000000111111111111
                                        111111111111


