WE          ./textures/42.png
SO          ./textures/1337.png
NO          ./textures/nettalha.png
EA          ./textures/okamili.png



C 135,206,0
F 42,42,46



                                                11111
                                           1111100000111
                                          10000000000001
                                          10111110000001
                                          10011110000001
                                        111101111111111111111111111
                                        100000000000000000000000001
                                        110111111111111111111111011
                                        100000000000000000000111011
                                        111000000001001010101111011
                                        111111100000011111101111011
                                        111100000000000000000111011
                                        100000000001000000000000001
                                        100000000010000000000100001
                                        100000000000000000001111111
                                        1000000000111111111111
                                        1000000000000000000001
                                        1000000000100000000001
                                        1000000000111111101111
                                        1111111111W0000000000111
                                        111111100000000000011111
                                        111111111111111111111111


