WE          ./textures/orange.png
SO          ./textures/green.png
NO          ./textures/red.png
EA          ./textures/purple.png



F 255,19,0
C 196,142,246


                                  111111111111
                                  100000000001
                                  100000000001
                                  100000000001
                                  111110011111
                                      1001
                                      1001
                        11111111111111100111111111111111
                        10000000000000000000000000000001
                        10011111111111100111111111111001
                        10011111111111100111111111111001
         11111111       10011111111111100111111111111001       11111111
         10000001       10011111111111100111111111111001       10000001
         10000001       10011111111000000000001111111001       10000001
         10000001111111110011111111000000000001111111001111111110000001
         10000000000000000000000000000010100000000000000000000000000001
         10000000000000000000000000000001000000000000000000000000000001
         10000001111111110011111111000010100001111111001111111110000001
         10000001       10011111111000000000001111111001       10000001
         10000001       10011111111000000000001111111001       10000001
         11111111       10011111111111100111111111111001       11111111
                        10011111111111100111111111111001
                        10011111111111100111111111111001
                        10011111111111100111111111111001
                        100000000000000N0000000000000001
                        11111111111111111111111111111111

